# This is a first map. It is a tech demo of the "map engine"
# The map has a field of 15x15
0x20;0x20;0x20;0x20;0x20;0x20;0x20;0x20;0x20;0x20;0x20;0x20;0x20;0x20;0x20
0x20;0x01;0x00;0x00;0x00;0x00;0x00;0x00;0x00;0x00;0x00;0x00;0x00;0x01;0x20
0x20;0x01;0x10;0x10;0x20;0x20;0x20;0x20;0x20;0x20;0x20;0x20;0x20;0x01;0x20
0x20;0x01;0x10;0x10;0x20;0x20;0x20;0x20;0x20;0x01;0x01;0x01;0x20;0x01;0x20
0x20;0x01;0x10;0x10;0x20;0x20;0x20;0x20;0x20;0x01;0x20;0x01;0x20;0x01;0x20
0x20;0x01;0x10;0x10;0x20;0x20;0x20;0x20;0x20;0x01;0x20;0x01;0x20;0x01;0x20
0x20;0x01;0x10;0x10;0x20;0x20;0x20;0x20;0x20;0x01;0x20;0x01;0x20;0x01;0x20
0x20;0x01;0x10;0x11;0x20;0x20;0x20;0x20;0x20;0x01;0x20;0x01;0x20;0x01;0x20
0x20;0x01;0x10;0x11;0x20;0x20;0x20;0x20;0x20;0x01;0x20;0x01;0x20;0x01;0x20
0x20;0x01;0x10;0x11;0x00;0x01;0x01;0x20;0x20;0x01;0x20;0x01;0x20;0x01;0x20
0x20;0x00;0x10;0x11;0x00;0x20;0x20;0x20;0x20;0x01;0x20;0x01;0x20;0x01;0x20
0x20;0x00;0x10;0x20;0x00;0x20;0x20;0x20;0x20;0x01;0x20;0x01;0x20;0x01;0x20
0x20;0x00;0x00;0x20;0x00;0x20;0x20;0x20;0x20;0x01;0x20;0x01;0x20;0x01;0x20
0x20;0xFF;0x20;0x21;0x01;0x01;0x01;0x01;0x01;0x01;0x20;0x01;0x01;0x01;0x20
0x20;0x20;0x20;0x20;0x20;0x20;0x20;0x20;0x20;0x20;0x20;0x20;0x20;0x20;0x20